1111111111111111111111111111111111
1P001C000000100C00000C0000000001E1
10101101101010111011110101CC010101
10101101101C10100C1111010111010101
10C01C011000C0100010000100000001C1
10001C011000101C00100C010000010101
10101101C0101010101001011111010001
1010110110101010001C01000001010111
100000000C10C0000011111100000000C1
1111111111111111111111111111111111